1a 1a 1a 1a 1a 1a 1a 1a 1a 1a 1a 1a 1a 1a 1a 1a 1a 1a 1a 1a 1a 1a 1a 1a 1a 1a 1a 1a 1a 1a 1a 1a 1a 1a 1a 1a 1a 1a 1a 1a 1a 1a 1a 1a 1a 1a 1a 1a 1a 1a 1a 1a 1a 1a 1a 1a 
1a 1a 1a 1a 1a 1a 1a 1a 1a 1a 1a 1a 1a 1a 1a 1a 1a 1a 1a 1a 1a 1a 1a 1a 1a 1a 1a 1a 1a 1a 1a 1a 1a 1a 1a 1a 1a 1a 1a 1a 1a 1a 1a 1a 1a 1a 1a 1a 1a 1a 1a 1a 1a 1a 1a 1a 
1a 1a 1a 1a 1a 1a 1a 1a 1a 1a 1a 1a 1a 1a 1a 1a 1a 1a 1a 1a 1a 1a 1a 1a 1a 1a 1a 1a 1a 1a 1a 1a 1a 1a 1a 1a 1a 1a 1a 1a 1a 1a 1a 1a 1a 1a 1a 1a 1a 1a 1a 1a 1a 1a 1a 1a 
1a 1a 1a 1a 1a 1a 1a 1a 1a 1a 1a 1a 1a 1a 1a 1a 1a 1a 1a 1a 1a 1a 1a 1a 1a 1a 1a 1a 1a 1a 1a 1a 1a 1a 1a 1a 1a 1a 1a 1a 1a 1a 1a 1a 1a 1a 1a 1a 1a 1a 1a 1a 1a 1a 1a 1a
1a 1a 1a 1a 1a 1a 1a 1a 1a 1a 1a 1a 1a 1a 1a 1a 1a 1a 1a 1a 1a 1a 1a 1a 1a 1a 1a 1a 1a 1a 1a 1a 1a 1a 1a 1a 1a 1a 1a 1a 1a 1a 1a 1a 1a 1a 1a 1a 1a 1a 1a 1a 1a 1a 1a 1a
1a 1a 1a 1a 1a 1a 1a 1a 1a 1a 1a 1a 1a 1a 1a 1a 1a 1a 1a 1a 1a 1a 1a 1a 1a 1a 1a 1a 1a 1a 1a 1a 1a 1a 1a 1a 1a 1a 1a 1a 1a 1a 1a 1a 1a 1a 1a 1a 1a 1a 1a 1a 1a 1a 1a 1a
1a 1a 1a 1a 1a 1a 1a 1a 1a 1a 1a 1a 1a 1a 1a 1a 1a 1a 1a 1a 1a 1a 1a 1a 1a 1a 1a 1a 1a 1a 1a 1a 1a 1a 1a 1a 1a 1a 1a 1a 1a 1a 1a 1a 1a 1a 1a 1a 1a 1a 1a 1a 1a 1a 1a 1a
1a 1a 1a 1a 1a 1a 1a 1a 1a 1a 1a 1a 1a 1a 1a 1a 1a 1a 1a 1a 1a 1a 1a 1a 1a 1a 1a 1a 1a 1a 1a 1a 1a 1a 1a 1a 1a 1a 1a 1a 1a 1a 1a 1a 1a 1a 1a 1a 1a 1a 1a 1a 1a 1a 1a 1a
1a 1a 1a 1a 1a 1a 1a 1a 1a 1a 1a 1a 1a 1a 1a 1a 1a 1a 1a 1a 1a 1a 1a 1a 1a 1a 1a 1a 1a 1a 1a 1a 1a 1a 0a 0a 0a 0a 0a 0a 0a 0a 0a 1a 1a 1a 1a 1a 1a 1a 1a 1a 1a 1a 1a 1a
1a 1a 1a 1a 1a 1a 1a 1a 1a 1a 1a 1a 1a 1a 1a 1a 1a 1a 1a 1a 1a 1a 1a 1a 1a 1a 1a 1a 1a 1a 1a 1a 1a 1a 0a 1a 1a 1a 1a 1a 1a 1a 0a 1a 1a 1a 1a 1a 1a 1a 1a 1a 1a 1a 1a 1a
1a 1a 1a 1a 1a 1a 1a 1a 1a 1a 1a 1a 1a 1a 1a 1a 1a 1a 1a 1a 1a 1a 1a 0a 0a 0a 0a 0a 0a 0a 0a 0a 1a 1a 0a 1a 1a 1a 1a 1a 1a 1a 0a 1a 1a 1a 1a 1a 1a 1a 1a 1a 1a 1a 1a 1a
1a 1a 1a 1a 1a 1a 1a 1a 1a 1a 1a 1a 1a 1a 1a 1a 1a 1a 1a 1a 0a 0a 0a 0a 0a 0a 0a 0a 0a 0a 0a 0a 1a 1a 0a 1a 1a 1a 1a 1a 1a 0a 0a 0a 0a 0a 0a 1a 1a 1a 1a 1a 1a 1a 1a 1a
1a 1a 1a 1a 1a 1a 1a 1a 1a 1a 1a 1a 1a 1a 1a 1a 1a 1a 1a 1a 0a 1a 1a 0a 0a 0a 0a 0a 0a 0a 0a 0a 1a 1a 0a 1a 1a 1a 0a 0a 0a 0a 0a 0a 0a 0a 0a 0a 0a 0a 1a 1a 1a 1a 1a 1a
1a 1a 1a 1a 1a 1a 1a 1a 1a 1a 1a 1a 1a 1a 1a 1a 1a 1a 1a 1a 0a 1a 1a 0a 0a 0a 0a 0a 0a 0a 0a 0a 1a 1a 0a 1a 1a 1a 0a 1a 1a 0a 0a 0a 0a 0a 0a 1a 1a 0a 1a 1a 1a 1a 1a 1a
1a 1a 1a 1a 1a 1a 1a 1a 1a 1a 1a 1a 1a 1a 1a 1a 1a 1a 1a 1a 0a 1a 1a 0a 0a 0a 0a 0a 0a 0a 0a 0a 0a 0a 0a 0a 0a 0a 0a 1a 1a 0a 0a 0a 0a 0a 0a 1a 1a 0a 1a 1a 1a 1a 1a 1a
1a 1a 1a 1a 1a 1a 1a 1a 1a 1a 1a 1a 1a 1a 1a 1a 1a 1a 1a 1a 0a 1a 1a 0a 0a 0a 0a 0a 0a 0a 0a 0a 1a 1a 1a 1a 1a 1a 1a 1a 1a 0a 0a 0a 0a 0a 0a 1a 1a 0a 1a 1a 1a 1a 1a 1a
1a 1a 1a 1a 1a 1a 1a 1a 1a 1a 1a 1a 1a 1a 1a 1a 1a 1a 1a 1a 0a 1a 1a 0a 0a 0a 0a 0a 0a 0a 0a 0a 1a 1a 1a 1a 1a 1a 1a 1a 1a 1a 1a 1a 0a 1a 1a 1a 1a 0a 1a 1a 1a 1a 1a 1a
1a 1a 1a 1a 1a 1a 1a 1a 1a 1a 1a 1a 0a 0a 0a 0a 0a 0a 0a 0a 0a 1a 1a 1a 1a 1a 1a 1a 1a 1a 1a 1a 1a 1a 1a 1a 1a 1a 1a 1a 1a 1a 1a 1a 0a 1a 1a 1a 1a 0a 1a 1a 1a 1a 1a 1a
1a 1a 1a 1a 1a 1a 1a 1a 1a 1a 1a 1a 0a 1a 1a 1a 1a 1a 1a 1a 1a 1a 1a 1a 1a 1a 1a 1a 1a 1a 1a 1a 1a 1a 1a 1a 1a 1a 1a 1a 1a 1a 0a 0a 0a 1a 1a 1a 1a 0a 1a 1a 1a 1a 1a 1a
1a 1a 1a 1a 1a 1a 1a 1a 1a 1a 1a 1a 0a 1a 1a 1a 1a 1a 1a 1a 1a 1a 1a 1a 1a 1a 1a 1a 1a 1a 1a 1a 1a 1a 1a 1a 1a 1a 1a 1a 1a 1a 0a 1a 1a 1a 1a 1a 1a 0a 1a 1a 1a 1a 1a 1a
1a 1a 1a 1a 1a 1a 1a 1a 1a 1a 1a 0a 0a 0a 0a 0a 0a 1a 1a 1a 1a 1a 1a 1a 1a 1a 1a 1a 1a 1a 1a 1a 1a 1a 1a 1a 1a 1a 1a 1a 1a 1a 0a 1a 1a 1a 1a 1a 1a 0a 1a 1a 1a 1a 1a 1a
1a 1a 1a 1a 1a 1a 1a 1a 1a 1a 1a 0a 0a 0a 0a 0a 0a 1a 1a 1a 1a 1a 1a 1a 1a 1a 1a 1a 1a 1a 1a 1a 1a 1a 1a 1a 1a 1a 1a 1a 1a 1a 0a 1a 1a 1a 1a 1a 1a 0a 1a 1a 1a 1a 1a 1a
1a 1a 1a 1a 1a 1a 1a 1a 0a 0a 0a 0a 0a 0a 0a 0a 0a 1a 1a 1a 1a 1a 1a 1a 1a 1a 1a 1a 1a 1a 1a 1a 1a 1a 1a 1a 1a 1a 1a 1a 1a 1a 0a 1a 1a 1a 1a 1a 1a 0a 1a 1a 1a 1a 1a 1a
1a 1a 1a 1a 1a 1a 1a 1a 0a 1a 1a 0a 0a 0a 0a 0a 0a 1a 1a 1a 1a 1a 1a 1a 1a 1a 1a 1a 1a 1a 1a 1a 1a 1a 1a 1a 1a 1a 1a 1a 1a 1a 0a 0a 0a 0a 0a 0a 0a 0a 1a 1a 1a 1a 1a 1a
1a 1a 1a 1a 1a 1a 1a 1a 0a 1a 1a 0a 0a 0a 0a 0a 0a 1a 1a 1a 1a 1a 1a 1a 1a 1a 1a 1a 1a 1a 1a 1a 1a 1a 1a 1a 1a 1a 1a 1a 1a 1a 0a 1a 1a 1a 1a 0a 1a 1a 1a 1a 1a 1a 1a 1a
1a 1a 1a 1a 1a 1a 1a 1a 0a 1a 1a 1a 1a 1a 0a 1a 1a 1a 1a 1a 1a 1a 1a 1a 1a 1a 1a 1a 1a 1a 1a 1a 1a 1a 1a 1a 1a 1a 1a 1a 1a 1a 0a 1a 1a 1a 1a 0a 1a 1a 1a 1a 1a 1a 1a 1a
1a 1a 1a 1a 1a 1a 1a 1a 0a 1a 1a 1a 1a 1a 0a 1a 1a 1a 1a 1a 1a 1a 1a 1a 1a 1a 1a 1a 1a 1a 1a 1a 1a 1a 1a 1a 1a 1a 1a 1a 0a 0a 0a 0a 0a 1a 1a 0a 1a 1a 1a 1a 1a 1a 1a 1a
1a 1a 1a 1a 1a 1a 1a 1a 0a 1a 1a 1a 1a 1a 0a 1a 1a 1a 1a 1a 1a 1a 1a 1a 0a 0a 0a 0a 0a 0a 0a 1a 1a 1a 1a 1a 1a 1a 1a 1a 0a 0a 0a 0a 0a 1a 1a 0a 1a 1a 1a 1a 1a 1a 1a 1a
1a 1a 1a 1a 1a 1a 1a 1a 0a 0a 0a 0a 0a 0a 0a 0a 0a 0a 0a 0a 0a 0a 0a 0a 0a 0a 0a 0a 0a 0a 0a 0a 0a 0a 0a 0a 0a 0a 0a 0a 0a 0a 0a 0a 0a 0a 0a 0a 1a 1a 1a 1a 1a 1a 1a 1a
1a 1a 1a 1a 1a 1a 1a 1a 1a 1a 1a 1a 1a 1a 1a 1a 1a 1a 1a 1a 1a 1a 1a 1a 0a 0a 0a 0a 0a 0a 0a 1a 1a 1a 1a 1a 1a 1a 1a 1a 0a 0a 0a 0a 0a 1a 1a 1a 1a 1a 1a 1a 1a 1a 1a 1a
1a 1a 1a 1a 1a 1a 1a 1a 1a 1a 1a 1a 1a 1a 1a 1a 1a 1a 1a 1a 1a 1a 1a 1a 0a 0a 0a 0a 0a 0a 0a 1a 1a 1a 1a 1a 1a 1a 1a 1a 1a 0a 1a 1a 1a 1a 1a 1a 1a 1a 1a 1a 1a 1a 1a 1a
1a 1a 1a 1a 1a 1a 1a 1a 1a 1a 1a 1a 1a 1a 1a 1a 1a 1a 1a 1a 1a 1a 1a 1a 0a 0a 0a 0a 0a 0a 0a 1a 1a 1a 1a 1a 1a 1a 1a 1a 1a 0a 1a 1a 1a 1a 1a 1a 1a 1a 1a 1a 1a 1a 1a 1a
1a 1a 1a 1a 1a 1a 1a 1a 1a 1a 1a 1a 1a 1a 1a 1a 1a 1a 1a 1a 1a 1a 1a 1a 1a 1a 0a 1a 1a 1a 1a 1a 1a 1a 1a 1a 1a 1a 1a 1a 1a 0a 0a 0a 0a 0a 0a 0a 0a 1a 1a 1a 1a 1a 1a 1a
1a 1a 1a 1a 1a 1a 1a 1a 1a 1a 1a 1a 1a 1a 1a 1a 1a 1a 1a 1a 1a 1a 1a 1a 1a 1a 0a 1a 1a 1a 1a 1a 1a 1a 1a 1a 1a 1a 1a 1a 1a 0a 1a 0a 1a 1a 1a 1a 0a 1a 1a 1a 1a 1a 1a 1a
1a 1a 1a 1a 1a 1a 1a 1a 1a 1a 1a 1a 1a 1a 1a 1a 1a 1a 0a 0a 0a 0a 0a 0a 0a 0a 0a 0a 0a 0a 0a 1a 1a 1a 1a 1a 1a 1a 1a 1a 1a 0a 1a 0a 1a 1a 1a 1a 0a 1a 1a 1a 1a 1a 1a 1a
1a 1a 1a 1a 1a 1a 1a 1a 1a 1a 1a 1a 1a 1a 1a 1a 1a 1a 0a 1a 1a 1a 1a 1a 1a 1a 1a 1a 1a 1a 0a 1a 1a 1a 1a 1a 1a 1a 1a 1a 1a 0a 1a 0a 1a 1a 1a 1a 0a 1a 1a 1a 1a 1a 1a 1a
1a 1a 1a 1a 1a 1a 1a 1a 1a 1a 1a 1a 1a 1a 1a 1a 1a 1a 0a 1a 1a 1a 1a 1a 1a 1a 1a 1a 1a 1a 0a 1a 1a 1a 1a 1a 1a 1a 1a 1a 1a 0a 1a 0a 1a 1a 1a 1a 0a 1a 1a 1a 1a 1a 1a 1a
1a 1a 1a 1a 1a 1a 1a 1a 1a 1a 1a 1a 1a 1a 1a 1a 1a 1a 0a 1a 1a 1a 1a 1a 1a 1a 1a 1a 1a 1a 0a 1a 1a 1a 1a 1a 1a 1a 1a 1a 1a 0a 1a 0a 1a 1a 1a 1a 0a 1a 1a 1a 1a 1a 1a 1a
1a 1a 1a 1a 1a 1a 1a 1a 1a 1a 1a 1a 1a 1a 1a 1a 1a 1a 0a 1a 1a 1a 1a 1a 1a 1a 1a 1a 1a 1a 0a 1a 1a 1a 1a 1a 1a 1a 1a 1a 1a 0a 0a 0a 1a 1a 1a 1a 0a 1a 1a 1a 1a 1a 1a 1a
1a 1a 1a 1a 1a 1a 1a 1a 1a 1a 1a 1a 1a 1a 1a 1a 1a 1a 0a 1a 1a 1a 1a 1a 1a 1a 1a 1a 1a 1a 0a 1a 1a 1a 1a 1a 1a 1a 1a 1a 1a 1a 1a 0a 1a 1a 1a 1a 0a 1a 1a 1a 1a 1a 1a 1a
1a 1a 1a 1a 1a 1a 1a 1a 1a 1a 1a 1a 1a 1a 1a 1a 1a 1a 0a 1a 1a 1a 1a 1a 1a 1a 1a 1a 1a 1a 0a 1a 1a 1a 1a 1a 1a 1a 1a 1a 1a 1a 1a 0a 1a 1a 1a 1a 0a 1a 1a 1a 1a 1a 1a 1a
1a 1a 1a 1a 1a 1a 1a 1a 1a 1a 1a 1a 1a 1a 1a 1a 1a 1a 0a 1a 1a 0a 0a 0a 0a 0a 0a 0a 1a 1a 0a 1a 1a 1a 1a 1a 1a 1a 1a 1a 1a 0a 0a 0a 0a 0a 1a 1a 0a 1a 1a 1a 1a 1a 1a 1a
1a 1a 1a 1a 1a 1a 1a 1a 1a 1a 1a 1a 1a 1a 1a 1a 1a 1a 0a 1a 1a 0a 0a 0a 0a 0a 0a 0a 1a 1a 0a 1a 1a 1a 1a 1a 1a 1a 1a 1a 1a 0a 0a 0a 0a 0a 0a 0a 0a 1a 1a 1a 1a 1a 1a 1a
1a 1a 1a 1a 1a 1a 1a 1a 1a 1a 1a 1a 1a 1a 1a 1a 1a 1a 0a 1a 1a 0a 0a 0a 0a 0a 0a 0a 0a 0a 0a 1a 1a 1a 1a 1a 1a 1a 1a 1a 1a 0a 0a 0a 0a 0a 1a 1a 1a 1a 1a 1a 1a 1a 1a 1a
1a 1a 1a 1a 1a 1a 1a 1a 1a 1a 1a 1a 1a 1a 1a 1a 1a 1a 0a 0a 0a 0a 0a 0a 0a 0a 0a 0a 1a 1a 0a 1a 1a 1a 1a 1a 1a 1a 1a 1a 1a 0a 0a 0a 0a 0a 1a 1a 1a 1a 1a 1a 1a 1a 1a 1a
1a 1a 1a 1a 1a 1a 1a 1a 1a 1a 1a 1a 1a 1a 1a 1a 1a 1a 1a 1a 1a 0a 0a 0a 0a 0a 0a 0a 1a 1a 0a 1a 1a 1a 1a 1a 1a 1a 1a 1a 1a 0a 0a 0a 0a 0a 1a 1a 1a 1a 1a 1a 1a 1a 1a 1a
1a 1a 1a 1a 1a 1a 1a 1a 1a 1a 1a 1a 1a 1a 1a 1a 1a 1a 1a 1a 1a 1a 1a 1a 1a 1a 1a 1a 1a 1a 0a 1a 1a 1a 1a 1a 1a 1a 1a 1a 1a 1a 1a 0a 1a 1a 1a 1a 1a 1a 1a 1a 1a 1a 1a 1a
1a 1a 1a 1a 1a 1a 1a 1a 1a 1a 1a 1a 1a 1a 1a 1a 1a 1a 1a 1a 1a 1a 1a 1a 1a 1a 1a 1a 1a 1a 0a 1a 1a 1a 1a 1a 1a 1a 1a 1a 1a 1a 1a 0a 1a 1a 1a 1a 1a 1a 1a 1a 1a 1a 1a 1a
1a 1a 1a 1a 1a 1a 1a 1a 1a 1a 1a 1a 1a 1a 1a 1a 1a 1a 1a 1a 1a 1a 1a 1a 1a 1a 1a 1a 1a 1a 0a 0a 0a 0a 0a 0a 0a 0a 0a 0a 0a 0a 0a 0a 1a 1a 1a 1a 1a 1a 1a 1a 1a 1a 1a 1a
1a 1a 1a 1a 1a 1a 1a 1a 1a 1a 1a 1a 1a 1a 1a 1a 1a 1a 1a 1a 1a 1a 1a 1a 1a 1a 1a 1a 1a 1a 1a 1a 1a 1a 1a 1a 1a 1a 1a 1a 1a 1a 1a 1a 1a 1a 1a 1a 1a 1a 1a 1a 1a 1a 1a 1a
1a 1a 1a 1a 1a 1a 1a 1a 1a 1a 1a 1a 1a 1a 1a 1a 1a 1a 1a 1a 1a 1a 1a 1a 1a 1a 1a 1a 1a 1a 1a 1a 1a 1a 1a 1a 1a 1a 1a 1a 1a 1a 1a 1a 1a 1a 1a 1a 1a 1a 1a 1a 1a 1a 1a 1a
1a 1a 1a 1a 1a 1a 1a 1a 1a 1a 1a 1a 1a 1a 1a 1a 1a 1a 1a 1a 1a 1a 1a 1a 1a 1a 1a 1a 1a 1a 1a 1a 1a 1a 1a 1a 1a 1a 1a 1a 1a 1a 1a 1a 1a 1a 1a 1a 1a 1a 1a 1a 1a 1a 1a 1a
1a 1a 1a 1a 1a 1a 1a 1a 1a 1a 1a 1a 1a 1a 1a 1a 1a 1a 1a 1a 1a 1a 1a 1a 1a 1a 1a 1a 1a 1a 1a 1a 1a 1a 1a 1a 1a 1a 1a 1a 1a 1a 1a 1a 1a 1a 1a 1a 1a 1a 1a 1a 1a 1a 1a 1a
1a 1a 1a 1a 1a 1a 1a 1a 1a 1a 1a 1a 1a 1a 1a 1a 1a 1a 1a 1a 1a 1a 1a 1a 1a 1a 1a 1a 1a 1a 1a 1a 1a 1a 1a 1a 1a 1a 1a 1a 1a 1a 1a 1a 1a 1a 1a 1a 1a 1a 1a 1a 1a 1a 1a 1a 
1a 1a 1a 1a 1a 1a 1a 1a 1a 1a 1a 1a 1a 1a 1a 1a 1a 1a 1a 1a 1a 1a 1a 1a 1a 1a 1a 1a 1a 1a 1a 1a 1a 1a 1a 1a 1a 1a 1a 1a 1a 1a 1a 1a 1a 1a 1a 1a 1a 1a 1a 1a 1a 1a 1a 1a 
1a 1a 1a 1a 1a 1a 1a 1a 1a 1a 1a 1a 1a 1a 1a 1a 1a 1a 1a 1a 1a 1a 1a 1a 1a 1a 1a 1a 1a 1a 1a 1a 1a 1a 1a 1a 1a 1a 1a 1a 1a 1a 1a 1a 1a 1a 1a 1a 1a 1a 1a 1a 1a 1a 1a 1a 
42
41